8 15
2 2 2 3 3 4 4 4 5 5 2 2 2 5 5
2 2 3 3 4 4 4 5 5 2 2 2 5 5 4
2 3 3 4 4 4 5 5 2 2 2 5 5 4 4
3 3 4 4 4 5 2 2 2 5 5 4 4 3 3
4 4 4 5 5 2 2 2 5 5 4 4 3 3 3
4 4 5 5 2 2 2 5 5 4 4 3 3 3 2
5 5 5 2 2 2 5 5 4 4 3 3 3 2 2
0 0 1 0 0 1 0 0 1 0 0 1 0 0 1